111111111111111111111111
1E0000000000000000000001
100000000000000011111111
11111CC11100000000000C11
1P0C0C0C0C0C0CCCCCCC0001
111111111111111111111111
