11111111111111111111111111111111111111111111111111
10000000000000000000000000000000000000000000000001
100000000C0000000000000000000000000000000000000001
10000000000000000000000000000000000000000000000001
10000000000000000000000000000000000C00000000000001
10000000000000000000000000000000000000000000000001
10000000000000000000000000000000000000001000000001
10000000000000000000C00000000000000000001000000001
10000000000000000000000000000000000000001000000001
10000000000000000000000000000000000000001000000001
10000000000001111100000000000000000000001000000001
100000000000000000000000000P0000000000001000000001
1000000000000000000000000000000000000000C000000001
100000000000000C0000000000000000000000000000000001
100000000000000000000000000000000000000000000C00E1
11111111111111111111111111111111111111111111111111
